7,13
WWWWWWWWWWWWW
W_M_WTTTB__pW
W_A_Dz____WWW
W___WTTT__W__
W___WWWW__W__
W_E_W__WiiW__
WWWWW__WWWW__
