7,13
WWWWWWWWWWWWW
W_M_WTTTB__pW
W_A_D_____WWW
W___WTTT__W__
W___WWWW_WW__
W_E_W__WWzW__
W_WWW__WWWW__
