30,120
________________________________________________________________________________________________________________________
________________________________________________________________________________________________________________________
________________________________________________________________________________________________________________________
________________________________________________________________________________________________________________________
________________________________________________________________________________________________________________________
______WWWWWWWWWWWWWWWWWWWWWW_____________________________________________________________WWWWWWWWWWWWWWWWWWWWWW_________
______WTTT___________i_W___WWWWW_________________________________________________________WA_MTT_MA_TT_________WWWWW_____
______WTT__z____T______W____z_TWWW_______________________________________________________W___T_A__TT___i__M__WW_TTWWW___
______WT______T____i___W_z_____TTWW______________________________________________________WM_T___TTT______M__WW____TTWW__
______WT____TTT________W____i____TWW_____________________________________________________W_i__TTT_______M__WW___m___TWW_
______W______TTT_WWWWWWWW__________W_____________________________________________________W__TTT_____WWWWWWWW__________W_
______W_____T__TTWTA___MWW______z__W_____WWWWWWWWWW_____WWWWWW_________WWWWWWWW__________W_______i__WA____MWW_________W_
______W___T______D___B__TWW_______TWW____WTTT_A__MW__WWWW__MMWWWW___WWWWTTT___WWW________W_MTTT_____D___________m_____EW
______W__________WTA___MWWTT_____TTWWWWWWW________WWWW__________WW_WWTTT________WW_______WMTT____i__WA____MWW_________W_
______W_____z____WWWWWWWWT_________D__z_TW_____i__W_____i________WWWT______i_____WW______WTT________WWWWWWWW__________W_
______W__________TTTT______i______WWT_z__D________W________________D______________W______W______________A__WW___m___TWW_
______W__z______TTT______________WWWWWWWWW__i____AWWWDWWA___i______WWWWWW_________WW_____W_______________A__WW____TTWW__
______W_________T_____z______TTWWW_______W________W__z_WWA________WWW___WW_________W_____W____TT_TT____i__A__WW_TTWWW___
______W___________________TTWWWW_________W________W_____WW________W______W_________W_____W_____TT_____________WWWWW_____
______W__________WWWWWWWWWWWW____________WT_______W_z____W________W______W_________WWWWWWW______TT__WWWWWWWWWWWW________
______W__________W_______________________WT_______W__z_z_W___i____W______W_________WA___MW__i_______W___________________
______W_________TW_______________________WTT______W______W________W______W____m____WA___MW______TT__W___________________
WWWWWWW__________W_______________________W_TT___i_W___z__W________W______W_________D__B__D_____TT___W___________________
WTT___D____z____TW_______________________W_TTT____D______W____i__AW______W________TWA___MW__________W___________________
WT_p__W________TTW_______________________W__TTT___W_z__z_WT_______W______W________TWA___MW____TT__i_W___________________
WMA__TWT______TTTW_______________________W__TTTT__WWWWWWWWTM_____TW______W_____TTTTWWWWWWW___TT_____W___________________
WWWWWWWTT__TTTTTTW_______________________WB_i_TT_AW______WTTTTTTTTW______WM_TTTTTTTW_____W__________W___________________
______WWWWWWWWWWWW_______________________WWWWWWWWWW______WWWWWWWWWW______WWWWWWWWWWW_____WWWWWWWWWWWW___________________
________________________________________________________________________________________________________________________
________________________________________________________________________________________________________________________
